*******************
*1 c   cb*d   fc 2*
* ** ***c*c*** ** *
*cc    dcbc8    cc*
*f** * ***** * **c*
*bcd *ccb*cc * cbf*
**** ***d*c*** ****
*bcc *ccfcc c*cccd*
****c* **d**c* ****
*5   c *kcc*bc   6*
**** *c*****c*c****
*kdcc*cfc d  * dcf*
**** * ***** * ****
*  cfc   *bccfcc  *
*c** *** * *** **c*
*fc* 7ccbccfc  *cb*
**b* *c***** * *f**
*cc  *c  *   *  cc*
* ****** *c****** *
*3 c  ccc ccc  c 4*
*******************