***************
*1 c     cc  3*
* *b* * *f*c* *
*kfc     dcbcc*
* * * * * * * *
*ccdccfckcbcdc*
* *c* * *c* * *
* 5c     c6   *
* *c* * *c* * *
*cbc    cfcbcd*
* * * * * * * *
*  7ckfcbkc8  *
* * * * * * * *
*ccfc    ccdcc*
* *d* * *c*b* *
*4 c     cc  2*
***************