*****************
* 8bcf**dc   3***
* ***c**bc    ***
* *4  ccccc  ccf*
*f* *****f*****c*
*b*c*****c*****c*
* *c***** *****c*
* *c*****b*****c*
*cc   ccbc*****f*
* **7** *kcfb * *
* ****fc***** * *
* ****d******cbc*
*cd***bbcf**c**c*
*fb***kc*d**cd  *
** 5*****b**    *
**  *****  c   2*
***  ****bc******
***cb***cc*******
****cf*   *******
****  cb6********
****ccdc*********
**   ccc*********
**      *********
**1     *********
*****************