***********************
*fc1                cb*
*bc  *  ***** ***** cc*
*   *    fccfc  b *  2*
*  *     cckcc ****** *
*        cbddc    *6* *
*    **  cccfc  **  * *
*    **8            * *
*      *        fb    *
*  c f  *           * *
* k d c  *     c b c  *
* *c b    *     f k * *
* *        *   c d c  *
*           *       * *
* *  ff      *      * *
* *5*         *       *
* ****   ccfc 7**     *
* *  f   cbdd  **     *
*  ****  cckc      *  *
*    ****cfcf     *  3*
*cc     ****** ***  cc*
*fc4                cf*
***********************