******************
*1 cf *****b  ****
* ***cc****c**c 2*
*c*8cbc****cccc  *
*b*   ccbc  * cfc*
*cc c*dkc****    *
****f***  5* cccc*
***6 *** ***cbccc*
**** ***b  ccccfc*
***bc***c****c*d**
**** ***k**7     *
*c*  ***d** **d***
*  cfcccb** *cfcb*
**4* * *ccc *   **
**** * * ***    **
****ccfb fc    3**
******************