********************
*1  c   cbcc   c  3*
*  cf    cc    bc  *
*****cccdcbcfcc*****
*kdc   *  ***    cc*
*ccc   *    *    *k*
***c************ ***
*       ccccbcccc* *
* *7     *         *
* ****cc*****fd**c**
* *           **cb *
*    ccfcckccc *   *
*****  ccdcccd * 8 *
*****   ***    * ***
*ccbcc  ***    *cfc*
*    **  cccbcc*ccc*
*c*   **   c  **** *
*k*    **  c       *
*c*   ccccdccf     *
* *     ***    ckcc*
*         *     ****
*******cccfccccbc  *
*         ******   *
*  ccbcdcc * 5 *   *
*   ckcccc * * *   *
******   c *** *   *
*   c    c     fc***
*   b  cdbccb  c  **
*   c  cccfcc  c  **
*4  c **********  2*
********************