**********************************
*ccb              cfckcccbc     2*
* cfc   cccccc  8        fbc     *
*  *d*******d**d************d**cb*
*1 *cck* ccbcc*ccfcc  *cccbccc*kf*
**** bc*  cccc*  bbc  *ckcfcbc*cc*
*      *   fff* cccf  *       *  *
*      *   *cc*  *    *       *  *
*cccbcc*      *       * cfcc  *  *
*      *      *       *       *b *
*      *      *       *       *c *
*      *      *kcc    *ccc 7  *  *
*  *   *ccb*  *cf*    *cfc *  *  *
*  cfccdc  *  dcbc    dccb    *  *
*     4*c  c 5*ccc   6*ccc    * 3*
**********************************