******************************
***1    fcc    cbfcc    **  2*
**  ******* ***** *****  cb* *
**cbcc  cc* *cc *cckccc* *c  *
*  ***  * * * *   **** * **c**
*  ** cccc* * ccbccc   * **f**
** ***  *** **** ***  ** **c**
**fckc *ccfccb *cckcc* ccbc  *
*   cbc* ** **  **** * ** ****
* ****c*  *   *cbf * * **c* **
*ccc *    *** ****   * **bcc *
* ** ****  ** ******** * c*c**
* *      *7**    ccbf* * fcc *
*** *c** **** cdc ** * ** ****
*   *c *   ** dkd **   ** ****
*** *ccf** ** cdc **** **b****
*4* ***  *        ****b*    3*
* *cbf * ******** *  *c*c ****
*  c** *  c****** *  cfc*ccf *
* cbcc *c*   **   * ***cc**c**
*** ** *cc** ** ***    *c**cc*
***c**c*kc**  ccc  *8 **  * **
* cbc*c*dd************* * *cc*
*** **c*ccc  **    ***  *c* **
**f *  *  **    ** cdcc *c  **
** ***c*  ******   dkdc**c* **
*   *cc*cfffff    *cd*  * * **
* *   ***********  ddd  * * 6*
*5  ******************  * ****
******************************