*******************************
*1             d             3*
*      * * *   c   * * *      *
*              f              *
*              k              *
*kddbc         c         cbddk*
*    c         b         c    *
*    c *       c       * c    *
***  b       dcfcd       f  ***
*    c     5d  k  d7     d    *
* k  c     c   b   c     c    *
*    b  * *b   *   b* *  b    *
*    c     c   b   c     c  k *
*    c     8d  k  d6     d    *
***  b       dcfcd       f  ***
*    c *       c       * c    *
*    c         b         c    *
*kddbc         c         cbddk*
*              k              *
*              f              *
*      * * *   c   * * *      *
*4             d             2*
*******************************