******************************
*   c        ccccc           *
*   c        ccccc           *
*    c       ccccc           *
*     c      ccccc           *
*     ************           *
*     *  ccc     *           *
*     *    *************     *
*     *                *     *
*     *                *     *
*     *               cc     *
*     ******************     *
*     c                      *
*     ccccccccc              *
*             cccc           *
*     ccccccccc              *
******************************